キャタピー,虫,45,30,35,20,20,45,195
トランセル,虫,50,20,55,25,25,30,205
バタフリー,虫飛,60,45,50,90,80,70,395
コラッタA,悪無,30,56,35,25,35,72,253
ラッタA,悪無,75,71,70,40,80,77,413
オニスズメ,無飛,40,60,30,31,31,70,262
オニドリル,無飛,65,90,65,61,61,100,442
ピカチュウ,電,35,55,40,50,50,90,320
ライチュウA,電超,60,85,50,95,85,110,485
サンドA,氷鋼,50,75,90,10,35,40,300
サンドパンA,氷鋼,75,100,120,25,65,65,450
ピッピ,妖,70,45,48,60,65,35,323
ピクシー,妖,95,70,73,95,90,60,483
ロコンA,氷,38,41,40,50,65,65,299
キュウコンA,氷妖,73,67,75,81,100,109,505
プリン,無妖,115,45,20,45,25,20,270
プクリン,無妖,140,70,45,85,50,45,435
ズバット,毒飛,40,45,35,30,40,55,245
ゴルバット,毒飛,75,80,70,65,75,90,455
パラス,虫草,35,70,55,45,55,25,285
パラセクト,虫草,60,95,80,60,80,30,405
ディグダA,地鋼,10,55,30,35,45,90,265
ダグトリオA,地鋼,35,100,60,50,70,110,425
ニャースA,悪,40,35,35,50,40,90,290
ペルシアンA,悪,65,60,60,75,65,115,440
コダック,水,50,52,48,65,50,55,320
ゴルダック,水,80,82,78,95,80,85,500
マンキー,闘,40,80,35,35,45,70,305
オコリザル,闘,65,105,60,60,70,95,455
ガーディ,炎,55,70,45,70,50,60,350
ウインディ,炎,90,110,80,100,80,95,555
ニョロモ,水,40,50,40,40,40,90,300
ニョロゾ,水,65,65,65,50,50,90,385
ニョロボン,水闘,90,95,95,70,90,70,510
ケーシィ,超,25,20,15,105,55,90,310
ユンゲラー,超,40,35,30,120,70,105,400
フーディン,超,55,50,45,135,95,120,500
ワンリキー,闘,70,80,50,35,35,35,305
ゴーリキー,闘,80,100,70,50,60,45,405
カイリキー,闘,90,130,80,65,85,55,505
メノクラゲ,水毒,40,40,35,50,100,70,335
ドククラゲ,水毒,80,70,65,80,120,100,515
イシツブテA,岩電,40,80,100,30,30,20,300
ゴローンA,岩電,55,95,115,45,45,35,390
ゴローニャA,岩電,80,120,130,55,65,45,495
ヤドン,水超,90,65,65,40,40,15,315
ヤドラン,水超,95,75,110,100,80,30,490
コイル,電鋼,25,35,70,95,55,45,325
レアコイル,電鋼,50,60,95,120,70,70,465
ベトベターA,毒悪,80,80,50,40,50,25,325
ベトベトンA,毒悪,105,105,75,65,100,50,500
シェルダー,水,30,65,100,45,25,40,305
パルシェン,水氷,50,95,180,85,45,70,525
ゴース,霊毒,30,35,30,100,35,80,310
ゴースト,霊毒,45,50,45,115,55,95,405
ゲンガー,霊毒,60,65,60,130,75,110,500
スリープ,超,60,48,45,43,90,42,328
スリーパー,超,85,73,70,73,115,67,483
タマタマ,草超,60,40,80,60,45,40,325
ナッシーA,草竜,95,105,85,125,75,45,530
カラカラ,地,50,50,95,40,50,35,320
ガラガラA,炎霊,60,80,110,50,80,45,425
ラッキー,無,250,5,5,35,105,50,450
ガルーラ,無,105,95,80,40,80,90,490
トサキント,水,45,67,60,35,50,63,320
アズマオウ,水,80,92,65,65,80,68,450
ヒトデマン,水,30,45,55,70,55,85,340
スターミー,水超,60,75,85,100,85,115,520
ストライク,虫飛,70,110,80,55,80,105,500
エレブー,電,65,83,57,95,85,105,490
ブーバー,炎,65,95,57,100,85,93,495
カイロス,虫,65,125,100,55,70,85,500
ケンタロス,無,75,100,95,40,70,110,490
コイキング,水,20,10,55,15,20,80,200
ギャラドス,水飛,95,125,79,60,100,81,540
ラプラス,水氷,130,85,80,85,95,60,535
メタモン,無,48,48,48,48,48,48,288
イーブイ,無,55,55,50,45,65,55,325
シャワーズ,水,130,65,60,110,95,65,525
サンダース,電,65,65,60,110,95,130,525
ブースター,炎,65,130,60,95,110,65,525
ポリゴン,無,65,60,70,85,75,40,395
プテラ,岩飛,80,105,65,60,75,130,515
カビゴン,無,160,110,65,65,110,30,540
ミニリュウ,竜,41,64,45,50,50,50,300
ハクリュー,竜,61,84,65,70,70,70,420
カイリュー,竜飛,91,134,95,100,100,80,600
レディバ,虫飛,40,20,30,40,80,55,265
レディアン,虫飛,55,35,50,55,110,85,390
イトマル,虫毒,40,60,40,40,40,30,250
アリアドス,虫毒,70,90,70,60,70,40,400
クロバット,毒飛,85,90,80,70,80,130,535
チョンチー,水電,75,38,38,56,56,67,330
ランターン,水電,125,58,58,76,76,67,460
ピチュー,電,20,40,15,35,35,60,205
ピィ,妖,50,25,28,45,55,15,218
ププリン,無妖,90,30,15,40,20,15,210
ウソッキー,岩,70,100,115,30,65,30,410
ニョロトノ,水,90,75,75,90,100,70,500
エーフィ,超,65,65,60,130,95,110,525
ブラッキー,悪,95,65,110,60,130,65,525
ヤミカラス,悪飛,60,85,42,85,42,91,405
ヤドキング,水超,95,75,80,100,110,30,490
ムウマ,霊,60,60,60,85,85,85,435
ブルー,妖,60,80,50,40,40,30,300
グランブル,妖,90,120,75,60,60,45,450
ハッサム,虫鋼,70,130,100,55,80,65,500
ニューラ,悪氷,55,95,55,35,75,115,430
サニーゴ,水岩,65,55,95,65,95,35,410
デリバード,氷飛,45,55,45,65,45,75,330
エアームド,鋼飛,65,80,140,40,70,70,465
ポリゴン2,無,85,80,90,105,95,60,515
ドーブル,無,55,20,35,20,45,75,250
エレキッド,電,45,63,37,65,55,95,360
ブビィ,炎,45,75,37,70,55,83,365
ミルタンク,無,95,80,105,40,70,100,490
ハピナス,無,255,10,10,75,135,55,540
キャモメ,水飛,40,30,30,55,30,85,270
ペリッパー,水飛,60,50,100,95,70,65,440
アメタマ,虫水,40,30,32,50,52,65,269
アメモース,虫水,70,60,62,100,82,80,454
マクノシタ,闘,72,60,30,20,30,25,237
ハリテヤマ,闘,144,120,60,40,60,50,474
ノズパス,岩,30,45,135,45,90,30,375
ヤミラミ,悪霊,50,75,75,65,65,50,380
キバニア,水悪,45,90,20,65,20,65,305
サメハダー,水悪,70,120,40,95,40,95,460
ホエルコ,水,130,70,35,70,35,60,400
ホエルオー,水,170,90,45,90,45,60,500
コータス,炎,70,85,140,85,70,20,470
パッチール,無,60,60,60,60,60,60,360
ナックラー,地,45,100,45,45,45,10,290
ビブラーバ,地竜,50,70,50,50,50,70,340
フライゴン,地竜,80,100,80,80,80,100,520
ドジョッチ,水地,50,48,43,46,41,60,288
ナマズン,水地,110,78,73,76,71,60,468
ヒンバス,水,20,15,20,10,55,80,200
ミロカロス,水,95,60,79,100,125,81,540
ポワルン,無,70,70,70,70,70,70,420
アブソル,悪,65,130,60,75,60,75,465
ユキワラシ,氷,50,50,50,50,50,50,300
オニゴーリ,氷,80,80,80,80,80,80,480
ジーランス,水岩,100,90,130,45,65,55,485
ラブカス,水,43,30,55,40,65,97,330
タツベイ,竜,45,75,60,40,30,50,300
コモルー,竜,65,95,100,60,50,50,420
ボーマンダ,竜飛,95,135,80,110,80,100,600
ダンバル,鋼超,40,55,80,35,60,30,300
メタング,鋼超,60,75,100,55,80,50,420
メタグロス,鋼超,80,135,130,95,90,70,600
ズガイドス,岩,67,125,40,30,30,58,350
ラムパルド,岩,97,165,60,65,50,58,495
タテトプス,岩鋼,30,42,118,42,88,30,350
トリデプス,岩鋼,60,52,168,47,138,30,495
カラナクシ,水,76,48,48,57,62,34,325
トリトドン,水地,111,83,68,92,82,39,475
フワンテ,霊飛,90,50,34,60,44,70,348
フワライド,霊飛,150,80,44,90,54,80,498
ムウマージ,霊,60,60,60,105,105,105,495
ドンカラス,悪飛,100,125,52,105,52,71,505
ウソハチ,岩,50,80,95,10,45,10,290
ピンプク,無,100,5,5,15,65,30,220
フカマル,竜地,58,70,45,40,45,42,300
ガバイト,竜地,68,90,65,50,55,82,410
ガブリアス,竜地,108,130,95,80,85,102,600
ゴンベ,無,135,85,40,40,85,5,390
リオル,闘,40,70,40,35,40,60,285
ルカリオ,闘鋼,70,110,70,115,70,90,525
ケイコウオ,水,49,49,56,49,61,66,330
ネオラント,水,69,69,76,69,86,91,460
マニューラ,悪氷,70,120,65,45,85,125,510
ジバコイル,電鋼,70,70,115,130,90,60,535
エレキブル,電,75,123,67,95,85,95,540
ブーバーン,炎,75,95,67,125,95,83,540
リーフィア,草,65,110,130,60,65,95,525
グレイシア,氷,65,60,110,130,95,65,525
ポリゴンZ,無,85,80,70,135,75,90,535
ダイノーズ,岩鋼,60,55,145,75,150,40,525
ユキメノコ,氷霊,70,80,70,80,70,110,480
ヨーテリー,無,45,60,45,25,45,55,275
ハーデリア,無,65,80,65,35,65,60,370
ムーランド,無,85,110,90,45,90,80,500
ダンゴロ,岩,55,75,85,25,25,15,280
ガントル,岩,70,105,105,50,40,20,390
ギガイアス,岩,85,135,130,60,80,25,515
モンメン,草妖,40,27,60,37,50,66,280
エルフーン,草妖,60,67,85,77,75,116,480
チュリネ,草,45,35,50,70,50,30,280
ドレディア,草,70,60,75,110,75,90,480
メグロコ,地悪,50,72,35,35,35,65,292
ワルビル,地悪,60,82,45,45,45,74,351
ワルビアル,地悪,95,117,80,65,70,92,519
プロトーガ,水岩,54,78,103,53,45,22,355
アバゴーラ,水岩,74,108,133,83,65,32,495
アーケン,岩飛,55,112,45,74,45,70,401
アーケオス,岩飛,75,140,65,112,65,110,567
ヤブクロン,毒,50,50,62,40,62,65,329
ダストダス,毒,80,95,82,60,82,75,474
バニプッチ,氷,36,50,50,65,60,44,305
バニリッチ,氷,51,65,65,80,75,59,395
バイバニラ,氷,71,95,85,110,95,79,535
エモンガ,電飛,55,75,60,75,60,103,428
ママンボウ,水,165,75,80,40,45,65,470
ワシボン,無飛,70,83,50,37,50,60,350
ウォーグル,無飛,100,123,75,57,75,80,510
バルチャイ,悪飛,70,55,75,45,65,60,370
バルジーナ,悪飛,110,65,105,55,95,80,510
ヤヤコマ,無飛,45,50,43,40,38,62,278
ヒノヤコマ,炎飛,62,73,55,56,52,84,382
ファイアロー,炎飛,78,81,71,74,69,126,499
ヤンチャム,闘,67,82,62,46,48,43,348
ゴロンダ,闘悪,95,124,78,69,71,58,495
ニンフィア,妖,95,65,65,110,130,60,525
メレシー,岩妖,50,50,150,50,150,50,500
ヌメラ,竜,45,50,35,55,75,40,300
ヌメイル,竜,68,75,53,83,113,60,452
ヌメルゴン,竜,90,100,70,110,150,80,600
クレッフィ,鋼妖,57,80,91,80,87,75,470
ボクレー,霊草,43,70,48,50,60,38,309
オーロット,霊草,85,110,76,65,82,56,474
モクロー,草飛,68,55,55,50,50,42,320
フクスロー,草飛,78,75,75,70,70,52,420
ジュナイパー,草霊,78,107,75,100,100,70,530
ニャビー,炎,45,65,40,60,40,70,320
ニャヒート,炎,65,85,50,80,50,90,420
ガオガエン,炎悪,95,115,90,80,90,60,530
アシマリ,水,50,54,54,66,66,40,320
オシャマリ,水,60,69,69,91,81,50,420
アシレーヌ,水妖,80,74,74,126,116,60,530
ツツケラ,無飛,35,75,30,30,30,65,265
ケララッパ,無飛,55,85,50,40,50,75,355
ドデカバシ,無飛,80,120,75,75,75,80,485
ヤングース,無,48,70,30,30,30,45,253
デカグース,無,88,110,60,55,60,45,418
アゴジムシ,虫,47,62,45,55,45,46,300
デンジムシ,虫電,57,82,95,55,75,36,400
クワガノン,虫電,77,70,90,145,75,43,500
マケンカニ,闘,47,82,57,42,47,63,338
ケケンカニ,闘氷,97,132,77,62,67,43,478
オドリドリ,X飛,75,70,70,98,70,93,476
アブリー,虫妖,40,45,40,55,40,84,304
アブリボン,虫妖,60,55,60,95,70,124,464
イワンコ,岩,45,65,40,30,40,60,280
ルガルガン（昼）,岩,75,115,65,55,65,112,487
ルガルガン（夜）,岩,85,115,75,55,75,82,487
ヨワシ（単）,水,45,20,20,25,25,40,175
ヨワシ（群）,水,45,140,130,140,135,30,620
ヒドイデ,毒水,50,53,62,43,52,45,305
ドヒドイデ,毒水,50,63,152,53,142,35,495
ドロバンコ,地,70,100,70,45,55,45,385
バンバドロ,地,100,125,100,55,85,35,500
シズクモ,水虫,38,40,52,40,72,27,269
オニシズクモ,水虫,68,70,92,50,132,42,454
カリキリ,草,40,55,35,50,35,35,250
ラランテス,草,70,105,90,80,90,45,480
ネマシュ,草妖,40,35,55,65,75,15,285
マシェード,草妖,60,45,80,90,100,30,405
ヤトウモリ,毒炎,48,44,40,71,40,77,320
エンニュート,毒炎,68,64,60,111,60,117,480
ヌイコグマ,無闘,70,75,50,45,50,50,340
キテルグマ,無闘,120,125,80,55,60,60,500
アマカジ,草,42,30,38,30,38,32,210
アママイコ,草,52,40,48,40,48,62,290
アマージョ,草,72,120,98,50,98,72,510
キュワワー,妖,51,52,90,82,110,100,485
ヤレユータン,超無,90,60,80,90,110,60,490
ナゲツケサル,闘,100,120,90,40,60,80,490
コソクムシ,虫水,25,35,40,20,30,80,230
グソクムシャ,虫水,75,125,140,60,90,40,530
スナバァ,霊地,55,55,80,70,45,15,320
シロデスナ,霊地,85,75,110,100,75,35,480
ナマコブシ,水,55,60,130,30,130,5,410
タイプ：ヌル,無,95,95,95,95,95,59,534
シルヴァディ,無,95,95,95,95,95,95,570
メテノ（殻）,岩飛,60,60,100,60,100,60,440
メテノ（コア）,岩飛,60,100,60,100,60,120,500
ネッコアラ,無,65,115,65,75,95,65,480
バクガメス,炎竜,60,78,135,91,85,36,485
トゲデマル,電鋼,65,98,63,40,73,96,435
ミミッキュ,霊妖,55,90,80,50,105,96,476
ハギギシリ,水超,68,105,70,70,70,92,475
ジジーロン,無竜,78,60,85,135,91,36,485
ダダリン,霊草,70,131,100,86,90,40,517
ジャラコ,竜,45,55,65,45,45,45,300
ジャランゴ,竜闘,55,75,90,65,70,65,420
ジャラランガ,竜闘,75,110,125,100,105,85,600
カプ・コケコ,電妖,70,115,85,95,75,130,570
カプ・テテフ,超妖,70,85,75,130,115,95,570
カプ・ブルル,草妖,70,130,115,85,95,75,570
カプ・レヒレ,水妖,70,75,115,95,130,85,570
ウツロイド,岩毒,109,53,47,127,131,103,570
マッシブーン,虫闘,107,139,139,53,53,79,570
フェローチェ,虫闘,71,137,37,137,37,151,570
デンジュモク,電,83,89,71,173,71,83,570
テッカグヤ,鋼飛,97,101,103,107,101,61,570
カミツルギ,草鋼,59,181,131,59,31,109,570
アクジキング,悪竜,223,101,53,97,53,43,570
